10
10
##########
#........#
##..#.##.#
#...#..#..
####.#.###
.....#...#
####.##.##
##...##.##
##.......#
##########